#################################################################
#################################################################
#################################################################
#################################################################
#################################################################
#################################################################
#################################################################
#################################################################
#################################################################
#################################################################
#################################################################
##############################                             ######
############################## ##################          ######
############################## ##################          ######
############################## ##################          ######
#############################   #################          ######
#############################   #################          ######
#############################   #################          ######
#############################   #################          ######
#######################              ############          ######
#######################              ############          ######
#######################              ############          ######
#######################              ############################
#######################              ############################
#######################              ############################
#######################              ############################
############################## ##################################
############################## ##################################
############################## ##################################
############################## ##################################
###########################       ###############################
################               ##################################
####################       ######################################
################        #########################################
