##############################    ###############################
##############################    ###############################
##############################    ###############################
##############################    ###############################
##############################
##############################    ###############################
##############################    ###############################
##############################    ###############################
##############################    ###############################
##############################    ###############################
##############################    ###############################
##############################                             ######
############################## ##################          ######
############################## ##################          ######
############################## ##################          ######
############################## ##################          ######
#################################################          ######
############################## ##################          ######
############################## ##################          ######
#######################              ############          ######
#######################              ############          ######
#######################              ############          ######
#######################              ############################
#######################              ############################
#######################              ############################
#######################              ############################
############################## ##################################
############################## ##################################
############################## ##################################
############################## ##################################
###########################       ###############################
################               ##################################
####################       ### ##################################
                        ###### ##################################
