##############################    ###############################
##############################    ###############################
##############################    ###############################
##############################    ###############################
##############################
#################################################################
#################################################################
#################################################################
#################################################################
#########################     ###################################
######################### # # ###################################
######################### # # ##########                   ######
######################### # # ###################          ######
#################################################          ######
######################### # # ##############   ##          ######
######################### # # ###################          ######
######################### # # ###################          ######
######################### # # ###################          ######
######################### # # ###################          ######
#######################              ############          ######
#######################              ############          ######
#######################              ############          ######
#######################              ############################
#######################              ############################
#######################              ############################
#######################              ############################
############################## ##################################
############################## ##################################
############################## ##################################
############################## ##################################
###########################       ###############################
################               ##################################
####################       ### ##################################
                        ###### ##################################
